WE ./texture/masked.xpm
EA ./texture/rolling_stones.xpm
NO ./texture/rl_stones.xpm
SO ./texture/yoda.xpm


F 115,115,115
C 0,119,179



        1111 11111111111111111111
        1001 1000110000000000001
        101110001110000002020001
        1001000000000000000000001
111111111011000001110000000200001
100000000011000001110111111111111
11110111111111011000000010001
11000111111111011101010010001
11011111111111111111111111111
 101
11011111111111111111111111111
11000000110101011100000010001
100020000000S0001100002000001
10000000000000001101010010001
1100000111010101111101111000111
11110111 1110101 101111110001
11111111 1111111 111111111111