WE ./assets/WE.xpm
EA ./assets/EA.xpm
NO ./assets/NO.xpm
SO ./assets/SO.xpm


F 115,115,115
C 0,119,179

1
1111
10S1
1111