WE ./assets/WE.xpm
EA ./assets/EA.xpm
NO ./assets/NO.xpm
SO ./assets/SO.xpm


F 220,100,0
C 225,30,0

        1111111111111111111111111
        1000000000110000000000001
        1011000000010000000000001
        10010000000D0000000000001
111111111011000001010000000000001
100000000011000001110111111111111
11110111111111D11100000010001
1111D111111110001101010010001
11000000110101011100000010001
10000000000000001100000010001
100000000000000011010100D0001
11000001110101011111011110N0111
11110111 1110101 101111010001
11111111 1111111 111111111111